Accounting : ACCT
Art : ART
Arts : ARTS
Banking : BANK
Begining Piano : MUSU
Begining Wood : WOOD
Bioinformatics : BINF
Biological Sciences : BIOL
Biotechnology : BIOT
Botany : BTNY
Buisness Mathematics : BMAT
Business and Management : BUSN
CELT COURSES : CELT
Centre of Public Policy & Gov. : CPPG
Character Building : CB
Chemistry : CHEM
Chinese : CHIN
Christian Studies : CRST
Civics : CIVC
Comercial Practice : CMPR
Commerce : COMM
Commercial Geography : CMGE
Computer Science (COMP) : COMP
Computer Science (CSCS) : CSCS
Computer Science Transfer Case : CPP
Criminology : CRIM
Data Science : CSDS
Economics : ECON
Education : EDUC
Elected Ceramics Non Majors : ARTC
English : ENGL
English Language : LANG
English Literature : ELIT
English language Teaching : DELT
Environmental Science : ENVR
Ethics : ETH
First Aid,Safety,CRP : FASA
Food Safety Quality Management : FSQM
French : FREN
Geography : GEOG
German : GRMN
Health & Physical Education : HPED
History : HIST
Information Technology : CSIT
Intensive English : IEAP
Inter Urdu Elective : UREL
International Student Exchange : ISEP
Introduction to US Ethnic Stud : ETHN
Islamic Studies : ISLM
Korean : KORN
Linguistics : LING
Mass Communications : MCOM
Mathematics : MATH
Molecular Pathology & Genomics : MPGN
Music : MUS
Music : MUSC
Pakistan Culture : PKCL
Pakistan Studies : PKST
Persian : PERS
Pharmacy : PHRM
Philosophy : PHIL
Physics : PHYS
Political Science : PLSC
Psychology : PSYC
Public Policy & Gov. : PPAG
SAP : SAP
Short Hand & Typing : SHT
Sociology : SOCL
Software Engineering : CSSE
Spanish : SPAN
Sports : PHED
Statistics : STAT
Translation of the Holy Quran : T.QU
University : UNIV
Urdu : URDU
Writing and Communication : WRCM
Zoology : ZOOL
test : TEST
